####################
#      T           #
#                  #########
#      ####                #
#     @            #####   #
#          #####   #   #   #
#                  #   #   #
#                  #   #   #
#                  #   #TTT#
####################   #####